{"rows":7,"cols":10
  ,"flatBoard":[
    1,1,1,1,1,1,1,1,1,1,
    1,1,10,0,0,0,0,10,1,1,
    1,3,0,1,0,0,1,0,4,1,
    1,2,0,0,0,0,0,0,0,1,
    1,3,0,1,0,0,1,0,4,1,
    1,1,10,0,0,0,0,10,1,1,
    1,1,1,1,1,1,1,1,1,1],

  "tutorial": "Seeing double?\n\nGet all tunes on a goal to win."}
