{
  "rows":8,
  "cols":7,
  "flatBoard":[0,0,0,1,0,0,0,
                0,0,1,3,1,0,0,
                0,1,0,0,0,1,0,
                0,1,0,2,0,1,0,
                1,0,0,0,0,0,1,
                1,0,14,4,10,0,1,
                1,0,0,1,0,0,1,
                0,1,1,0,1,1,0]}
