{"rows":9,"cols":11,

  "flatBoard":

  [
    1,1,1,1,1,1,1,1,1,1,1,
    1,10,0,0,1,1,1,0,1,1,1,
    1,1,1,0,1,1,0,0,1,1,1,
    1,1,1,0,1,0,0,0,0,1,1,
    1,1,1,0,1,0,0,0,0,1,1,
    1,1,1,2,0,0,0,3,1,0,1,
    1,1,1,0,0,4,1,0,1,0,1,
    1,1,1,0,0,0,0,0,10,0,1,
    1,1,1,1,1,1,1,1,1,1,1],

  "lasers": [
      {
        "id":1,
        "startRow": 3,
        "startCol": 0,
        "direction": 1,
        "length": 10,
        "state": 1,
        "canCollide": 7
      }
      ]

  }
